19 29
133 133 133 81 56 57 58 57 51 52 58 57 58 57 58 57 58 57 58 51 52 57 58 59 86 133 133 133 133
133 133 133 81 72 73 74 73 67 68 74 73 74 73 74 73 74 73 74 67 68 73 74 75 86 133 133 133 133
133 133 133 81 72 83 83 83 83 83 83 83 83 83 83 83 83 83 83 83 83 83 83 75 86 133 133 133 133
133 133 133 81 72 83 84 83 83 83 83 83 83 83 83 83 83 83 83 83 83 84 83 75 86 133 133 133 133
133 131 131 81 88 83 83 83 83 83 83 201 202 202 134 135 135 136 83 83 83 83 83 75 86 131 131 131 133
81 50 51 52 56 83 83 83 83 83 83 217 218 218 150 151 151 152 83 83 83 83 83 59 58 57 58 59 86
81 66 67 68 68 83 83 83 83 83 83 83 83 83 83 83 83 83 83 83 83 83 83 73 74 73 74 75 86
81 72 83 83 83 83 83 83 83 83 83 83 83 83 83 83 83 83 83 83 83 83 83 83 83 83 90 75 92
81 88 83 83 83 83 83 83 83 83 83 83 83 83 83 83 83 83 83 83 83 83 83 83 83 83 83 91 92
81 66 83 83 83 83 83 83 83 83 83 83 83 83 83 83 83 83 83 83 83 83 83 83 83 83 83 91 86
97 98 99 114 115 83 83 83 83 83 83 83 83 83 83 83 83 83 83 83 83 83 83 83 122 123 106 107 102
133 133 133 81 82 83 83 83 83 83 83 83 83 83 83 83 83 83 83 83 83 83 83 83 75 86 133 133 133
133 133 133 81 82 83 83 83 83 83 83 83 83 83 83 83 83 83 83 83 83 83 83 83 91 86 133 133 133
133 133 133 81 82 83 83 83 83 83 83 201 202 202 134 135 135 136 83 83 83 83 83 83 75 86 133 133 133
133 133 133 81 82 83 83 83 83 83 83 217 218 218 150 151 151 152 83 83 83 83 83 83 91 86 133 133 133
133 133 133 81 82 83 83 83 83 83 83 83 83 83 83 83 83 83 83 83 83 83 83 83 91 86 133 133 133
133 133 133 81 82 83 83 83 83 83 83 83 83 83 83 83 83 83 83 83 83 83 83 83 91 86 133 133 133
133 133 133 81 82 83 83 83 83 83 83 83 83 83 83 83 83 83 83 83 83 83 83 83 75 86 133 133 133
133 133 133 97 104 106 106 106 106 106 106 106 106 106 106 106 106 106 106 106 106 106 106 106 101 108 133 133 133