
9 14
133 131 131 131 131 131 133 133 131 131 131 131 131 133
81 56 57 58 57 58 90 90 57 58 57 58 59 92
81 72 73 74 73 74 90 90 73 74 73 74 75 92
81 88 90 90 90 89 90 90 89 90 90 90 75 92
81 72 90 90 90 90 90 90 90 90 90 90 91 92
81 88 89 90 90 90 90 90 90 90 90 89 75 92
81 72 90 90 90 90 90 90 90 90 90 90 75 92
81 88 90 90 90 90 90 90 90 90 90 90 91 92
103 104 106 106 106 106 106 106 106 106 106 106 107 108

17 18
133 131 131 131 131 131 131 131 133 133 131 131 131 131 131 131 131 133
81 50 51 52 51 52 51 52 33 34 51 52 51 52 51 52 53 86
81 66 67 68 67 68 67 68 33 34 67 68 67 68 67 68 85 86
81 66 84 90 90 90 90 90 33 34 90 90 90 90 90 84 69 86
81 82 90 90 201 136 90 90 33 34 90 90 201 136 90 90 85 86
81 66 90 90 217 152 90 90 33 34 90 90 217 152 90 90 69 86
81 66 90 90 90 90 90 90 33 34 90 90 90 90 90 90 85 86
81 82 90 90 90 90 90 84 33 34 84 90 90 90 90 90 85 86
133 134 134 134 134 134 134 134 33 34 134 134 134 134 134 134 134 133
133 150 150 150 150 150 150 150 33 34 150 150 150 150 150 150 150 133
81 66 90 90 90 90 90 84 33 34 84 90 90 90 90 90 69 86
81 82 90 90 90 90 90 90 33 34 90 90 90 90 90 90 85 86
81 66 90 90 201 136 90 90 33 34 90 90 201 136 90 90 69 86
81 66 90 90 217 152 90 90 33 34 90 90 217 152 90 90 85 86
81 66 90 90 90 90 90 90 33 34 90 90 90 90 90 90 85 86
81 82 84 90 90 90 90 90 33 34 90 90 90 90 90 84 85 86
97 98 99 99 99 99 99 99 33 34 99 99 99 99 99 99 101 102


12 11
133 131 131 131 131 131 131 131 131 131 133
81 50 51 51 51 51 51 51 52 53 86
81 82 68 67 68 67 68 67 68 69 86
81 82 83 83 83 83 83 83 84 69 86
81 82 83 83 201 136 134 134 134 134 134
81 82 83 83 217 152 150 150 150 150 150
81 82 83 83 83 83 83 83 84 69 86
81 82 83 83 83 83 83 83 83 69 86
97 98 114 115 83 83 83 116 117 101 102
133 133 81 82 83 83 83 85 86 133 133
133 133 81 82 84 83 84 85 86 133 133
133 133 97 98 98 98 99 101 102 133 133


12 11
133 131 131 131 131 131 131 131 131 131 133
81 50 51 51 51 51 51 51 52 53 86
81 82 68 67 68 67 68 67 68 69 86
81 82 83 83 83 83 83 83 84 69 86
134 134 134 134 134 201 136 83 83 69 86
150 150 150 150 150 217 152 83 83 69 86
81 82 83 83 83 83 83 83 83 69 86
81 82 83 83 83 83 83 83 84 69 86
97 98 114 115 83 83 83 116 117 101 102
133 133 81 82 83 83 83 85 86 133 133
133 133 81 82 84 83 84 85 86 133 133
133 133 97 98 98 98 99 101 102 133 133


13 26
133 131 131 131 131 131 131 131 131 131 133 133 131 131 131 131 131 131 131 131 131 133 133 133 133 133
            81 50 51 52 51 52 51 52 51 52 33 34 51 52 51 52 51 52 51 52 53 86 133 133 133 133
            81 82 67 68 67 68 67 68 67 68 33 34 67 68 67 68 67 68 67 68 69 86 133 133 133 133
            81 66 90 90 90 90 90 90 90 90 33 34 90 90 90 90 90 90 90 90 85 86 131 131 131 133
            81 66 90 90 84 90 90 90 84 90 33 34 90 84 90 90 90 84 90 90 52 68 68 68 53 86
            81 82 90 90 90 1 33 2 90 90 33 34 90 90 1 34 2 90 90 90 68 68 68 68 69 86
            81 82 90 90 90 17 33 18 90 90 33 34 90 90 17 34 18 90 90 90 90 90 90 90 69 86
            81 82 90 90 84 90 90 90 84 90 33 34 90 84 90 90 90 84 90 90 90 90 90 84 85 86
            81 82 90 90 90 90 90 90 90 90 33 34 90 90 90 90 90 90 90 90 90 90 90 90 69 86
            81 82 90 90 201 202 135 136 90 90 33 34 90 90 201 202 135 136 90 90 116 117 99 99 101 86
            81 66 90 90 217 218 151 152 90 90 33 34 90 90 217 218 151 152 90 90 69 86 133 133 133 133
            81 82 90 90 90 90 90 90 90 90 33 34 90 90 90 90 90 90 90 90 85 86 133 133 133 133
            97 98 99 99 99 99 99 99 99 99 33 34 99 99 99 99 99 99 99 99 101 102 133 133 133 133


3 3
1 2 3
4 5 6
7 5 2