9 12
133 131 131 131 131 133 133 131 131 131 131 133
81 50 51 52 51 83 83 52 51 52 53 92
81 82 67 68 67 83 83 68 67 68 69 92
81 82 83 83 83 83 83 83 83 83 85 92
81 82 83 83 83 83 83 83 83 83 69 92
81 82 83 83 83 83 83 83 83 83 85 92
81 82 83 83 83 83 83 83 83 83 69 92
81 82 83 83 83 83 83 83 83 83 85 92
97 98 99 99 99 6 7 99 99 99 101 108

14 24
133 131 131 133 133 131 131 131 131 131 131 133 133 131 131 131 131 131 131 133 133 131 131 133
            81 50 51 83 83 52 51 52 51 52 51 33 83 52 51 52 51 52 51 83 83 52 53 86
            81 66 67 83 83 68 67 68 67 68 67 83 83 68 67 68 67 68 67 83 83 68 69 86
            81 66 83 83 83 83 83 83 83 83 83 33 83 83 83 83 83 83 83 83 83 83 69 86
            81 82 83 83 83 83 83 84 83 83 83 33 83 83 83 83 84 83 83 83 83 83 85 86
            81 66 83 83 83 83 83 83 83 83 83 83 34 83 83 83 83 83 83 83 83 83 69 86
            81 82 83 83 83 134 134 83 134 134 83 83 83 83 83 134 134 83 134 134 83 83 85 86
            81 66 83 150 150 83 83 83 150 83 83 33 83 83 83 83 83 83 83 83 83 83 69 86
            81 82 83 83 83 83 83 83 83 83 83 33 34 83 83 83 83 83 83 83 83 83 85 86
            81 82 83 84 83 83 83 83 83 83 83 33 34 83 83 83 83 83 83 83 84 83 69 86
            81 98 99 99 99 99 99 115 83 83 83 33 83 83 83 83 122 99 99 99 99 99 101 102
            133 133 133 133 133 133 81 66 83 83 83 33 34 83 83 83 75 86 133 133 133 133 133 133
            133 133 133 133 133 133 81 82 83 83 83 83 34 83 83 83 91 86 133 133 133 133 133 133
            133 133 133 133 133 133 97 98 99 99 99 33 34 99 99 106 107 86 133 133 133 133 133 133

13 22
133 131 131 131 133 133 131 131 131 131 131 131 131 131 131 131 133 133 131 131 131 133
            81 50 51 52 83 83 51 52 51 52 51 52 51 52 51 52 83 83 51 52 53 86
            81 66 67 68 83 83 67 68 67 68 67 68 67 68 67 68 83 83 67 68 69 86
            81 82 83 83 83 83 83 83 83 83 83 83 83 83 83 83 83 83 83 83 69 86
            81 66 83 83 83 83 83 83 83 83 83 83 83 83 83 83 83 83 83 83 85 86
            81 66 83 83 83 83 84 83 83 83 83 83 83 83 84 83 83 83 83 83 69 86
            81 66 83 83 83 83 83 83 83 83 83 83 83 83 83 83 83 83 83 83 83 83
            81 66 83 83 83 83 83 83 83 83 83 83 83 83 83 83 83 83 83 83 83 83
            81 66 83 83 83 83 83 83 83 83 83 83 83 83 83 83 83 83 83 83 85 86
            81 66 83 83 83 83 84 83 83 83 83 83 83 83 84 83 83 83 83 83 69 86
            81 66 83 83 83 83 83 83 83 83 83 83 83 83 83 83 83 83 83 83 69 86
            81 82 83 83 83 83 83 83 83 83 83 83 83 83 83 83 83 83 83 83 85 86
            97 98 98 99 99 99 99 99 99 99 99 99 99 99 99 99 83 83 99 99 101 102

14 10
133 142 142 142 83 83 142 142 142 133
            87 56 57 58 90 90 57 58 59 92
            87 72 73 74 90 90 73 74 75 92
            87 72 84 90 90 90 90 84 91 92
            87 88 90 90 90 90 90 90 75 92
            83 90 90 90 90 90 90 90 90 83
            83 90 90 90 90 90 90 90 90 83
            87 88 90 90 90 90 90 90 91 92
            87 72 90 90 90 90 90 90 75 92
            87 88 90 90 90 90 90 90 75 92
            87 88 90 90 90 90 90 90 75 92
            87 88 90 90 90 90 90 90 75 92
            87 88 84 90 90 90 90 84 91 92
            103 104 106 106 90 90 106 106 107 108

13 22
133 131 131 131 133 133 131 131 131 131 131 131 131 131 131 131 133 133 131 131 131 133
            81 50 51 52 83 83 51 52 51 52 51 52 51 52 51 52 83 83 51 52 53 86
            81 66 67 68 83 83 67 68 67 68 67 68 67 68 67 68 83 83 67 68 69 86
            81 82 83 83 83 83 83 83 83 83 83 83 83 83 83 83 83 83 83 83 69 86
            81 66 83 83 83 83 83 83 83 83 83 83 83 83 83 83 83 83 83 83 85 86
            81 66 83 83 83 83 84 83 83 83 83 83 83 83 84 83 83 83 83 83 69 86
            83 83 83 83 83 83 83 83 83 83 83 83 83 83 83 83 83 83 83 83 85 86
            83 83 83 83 83 83 83 83 83 83 83 83 83 83 83 83 83 83 83 83 85 86
            81 66 83 83 83 83 83 83 83 83 83 83 83 83 83 83 83 83 83 83 85 86
            81 66 83 83 83 83 84 83 83 83 83 83 83 83 84 83 83 83 83 83 69 86
            81 66 83 83 83 83 83 83 83 83 83 83 83 83 83 83 83 83 83 83 69 86
            81 82 83 83 83 83 83 83 83 83 83 83 83 83 83 83 83 83 83 83 85 86
            97 98 98 99 99 99 99 99 99 99 99 99 99 99 99 99 83 83 99 99 101 102

9 11
133 131 131 131 131 131 131 131 131 131 133
            81 50 51 52 51 52 51 51 52 53 86
            81 66 67 68 67 68 67 67 68 69 86
            81 82 84 83 83 83 83 83 83 69 86
            81 66 83 83 83 83 83 83 83 83 133
            81 82 83 83 83 83 83 83 83 83 133
            81 66 83 83 83 83 83 83 83 69 86
            81 82 83 83 83 83 83 83 84 85 86
            97 98 99 99 83 83 99 99 99 101 102

19 29
133 133 133 81 56 57 58 57 83 83 58 57 58 57 58 57 58 57 58 83 83 57 58 59 86 133 133 133 133
            133 133 133 81 72 73 74 73 83 83 74 73 74 73 74 73 74 73 74 83 83 73 74 75 86 133 133 133 133
            133 133 133 81 72 83 83 83 83 83 83 83 83 83 83 83 83 83 83 83 83 83 83 75 86 133 133 133 133
            133 133 133 81 72 83 84 83 83 83 83 83 83 83 83 83 83 83 83 83 83 84 83 75 86 133 133 133 133
            133 131 131 81 88 83 83 83 83 83 83 201 202 202 134 135 135 136 83 83 83 83 83 75 86 131 131 131 133
            81 50 51 52 56 83 83 83 83 83 83 217 218 218 150 151 151 152 83 83 83 83 83 59 58 57 58 59 86
            81 66 67 68 68 83 83 83 83 83 83 83 83 83 83 83 83 83 83 83 83 83 83 73 74 73 74 75 86
            90 90 83 83 83 83 83 83 83 83 83 83 83 83 83 83 83 83 83 83 83 83 83 83 83 83 90 90 90
            90 90 83 83 83 83 83 83 83 83 83 83 83 83 83 83 83 83 83 83 83 83 83 83 83 83 83 90 90
            81 66 83 83 83 83 83 83 83 83 84 83 83 83 83 83 83 83 84 83 83 83 83 83 83 83 83 91 86
            97 98 99 114 115 83 83 83 116 117 99 99 115 83 83 83 122 123 106 120 121 83 83 83 122 123 106 107 102
            133 133 133 81 82 83 83 83 69 86 133 87 66 83 83 83 85 86 133 87 72 83 83 83 75 86 133 133 133
            133 133 133 81 82 83 83 83 69 86 133 87 82 83 83 83 69 86 133 87 88 83 83 83 91 86 133 133 133
            133 133 133 81 82 83 83 83 69 86 133 87 66 83 83 83 85 86 133 87 72 83 83 83 75 86 133 133 133
            133 133 133 81 82 83 83 83 69 86 133 87 82 83 83 83 69 86 133 87 88 83 83 83 91 86 133 133 133
            133 133 133 81 82 83 83 83 69 86 133 87 66 83 83 83 85 86 133 87 72 83 83 83 91 86 133 133 133
            133 133 133 81 82 83 83 83 69 86 133 87 82 83 83 83 69 86 133 87 88 83 83 83 91 86 133 133 133
            133 133 133 81 82 83 83 83 69 86 133 87 66 83 83 83 69 86 133 87 72 83 83 83 75 86 133 133 133
            133 133 133 81 82 83 83 106 107 102 133 103 104 106 83 83 85 102 133 103 104 106 83 83 91 86 133 133 133

9 11
133 131 131 131 131 131 131 131 131 131 133
81 50 51 52 51 52 51 51 52 53 86
81 66 67 68 67 68 67 67 68 69 86
81 82 84 83 83 83 83 83 83 69 86
83 83 83 83 83 83 83 83 83 69 86
83 83 83 83 83 83 83 83 83 69 86
81 66 83 83 83 83 83 83 83 69 86
81 82 83 83 83 83 83 83 84 85 86
97 98 99 99 83 83 99 99 99 101 102
